11111111111111111111
10000000001000010001
10000100011000011001
10001111100000111101
1e011111000000000001
11111111111111111111
