11111111111111111111
100000000E1000010001
10000100011000011001
10001111100000111101
1P011111000000000001
11111111111111111111
